****************
*    *         *
*    *    ******
*         *  E *
*    *    ******
*    *    *    *
*S   *    *    *
****************